{
 "keys": [
  "", 
  "36", 
  "23", 
  "47", 
  "125", 
  "22", 
  "54", 
  "132", 
  "30", 
  "5", 
  "167", 
  "7"
 ], 
 "data": {}, 
 "grid": [
  "                                                                                                                                ", 
  "                                                                                                                                ", 
  "                                                                                                                                ", 
  "                                                                                                                                ", 
  "                                                                                                                                ", 
  "                                                                                                                                ", 
  "                                                                                                                                ", 
  "                                                                                                                                ", 
  "                                                                                                                                ", 
  "                                                                                                                                ", 
  "                                                                                                                                ", 
  "                                                                                                                                ", 
  "                                                                                                                                ", 
  "                                                                                                                                ", 
  "                                                                                                                                ", 
  "                                                                                                                                ", 
  "                                                                                                                                ", 
  "                                                                                                                                ", 
  "                                                                                                                                ", 
  "                                                                                                                                ", 
  "                                                                                                                                ", 
  "                                                                                                                                ", 
  "                                                                                                                                ", 
  "                                                                                                                                ", 
  "                                                                                                                                ", 
  "                                                                                                                                ", 
  "                                                                                                                                ", 
  "                                                                                                                                ", 
  "                                                                                                                                ", 
  "                                                                                                                                ", 
  "                                                                                                                                ", 
  "                                                                        !!!     # #                                             ", 
  "                                                                       $$$$!!! #############                                    ", 
  "                                                                       $ $$%!!!#             ###                                ", 
  "                                                                       $$%% %% #                ####                            ", 
  "                                                                       $    %% #                    #                           ", 
  "                                                                       %%  % #                       ##                         ", 
  "                                                                        %  %#                          #                        ", 
  "                                                                        %  %###  #                    #                         ", 
  "                                                                         % %% ###&#                  ##                         ", 
  "                                                                         %   %%&&&##                 #                          ", 
  "                                                                          %   %  &&&##              #                           ", 
  "                                                                          %   %&   &&#              #                           ", 
  "'                                                                          %% %&    &###            #                           ", 
  "'                                                                            %%&     &&#                                        ", 
  "                                                                               &    &&&            #                            ", 
  "                                                                                &  &(((#           #                            ", 
  "                                                                               )&&&&( (##         #                             ", 
  "                                                                               )&* *( (((#      ##                              ", 
  "                                                                              )) *  * ((((#   #                                 ", 
  "                                                                              ))*     *   #  #                                  ", 
  "                                                                              ))*     *(( #  #                                  ", 
  "                                                                              )*      ***## ##                                  ", 
  "                                                                               *       ##   #                                   ", 
  "                                                                             )*       *++###                                    ", 
  "                                                                             )*       *+ +                                      ", 
  "                                                                             ))*      *+++                                      ", 
  "                                                                             )*       ** +                                      ", 
  "                                                                             )*        *                                        ", 
  "                                                                            ))*    ****                                         ", 
  "                                                                            ) *    *                                            ", 
  "                                                                            )*   * *                                            ", 
  "                                                                            ))   *                                              ", 
  "                                                                            )    *                                              ", 
  "                                                                           )) * *                                               ", 
  "                                                                           ))) *                                                ", 
  "                                                                           ))*  **                                              ", 
  "                                                                           )** *                                                ", 
  "                                                                           ) **                                                 ", 
  "                                                                           )) )                                                 ", 
  "                                                                           )))))*                                               ", 
  "                                                                             )) **                                              ", 
  "                                                                                                                                ", 
  "                                                                                                                                ", 
  "                                                                                                                                ", 
  "                                                                                                                                ", 
  "                                                                                                                                ", 
  "                                                                                    ,,,,                                        ", 
  "                                                                                   ,,,,                                         ", 
  "                                                                                 ,,                                             ", 
  "                                                                                ,,                                              ", 
  "                                                                              , ,,,                                             ", 
  "                                                                             ,, ,  ,                                            ", 
  "                                                                             ,,, ,  ,                                   ,,,,,,,,", 
  "                                                       ,,,,     ,,             ,,  ,,                                ,,,        ", 
  "                               ,,,,,,,,,,,,,,,,, ,       ,,,,       ,,, ,,,,,   ,,,                                  ,          ", 
  "                         ,,,,,                     ,,,,,,,               ,,,,,,                                  ,,,,           ", 
  "                 ,,  ,,,,                                               ,,                                ,,,,                  ", 
  "            ,,,   ,,,,,,,                                               ,                    ,,,,     ,,,,,,                    ", 
  "                 ,      ,                                               ,,       ,,,,,     ,,,,,            ,                   ", 
  "                 ,,,,,,,                                                     ,,,,,                ,,,,,,,,,,                    ", 
  "                   ,,,                                                              ,,, ,,,,     ,,                             ", 
  " ,,, ,,,,                  ,                                                                                                    ", 
  ",          ,,,,,,,,,,,,,,,,                                                                                                     ", 
  ",                                                                                                                               ", 
  ",                                                                                                                               ", 
  "        ,,,,,,,,,,,,,,,,,,                                                                                            ,,,,,,,,, ", 
  "                                ,,,,,,,,,,,,,,                                                            ,,,,,,,,,,            ", 
  "                                                   ,,,,,,,,,,,,,,,,,,                  ,,,,,,,,,,,,,,,,                         ", 
  "                                                                                                                                ", 
  "                                                                                                                                ", 
  "                                                                                                                                ", 
  "                                                                                                                                ", 
  "                                                                                                                                ", 
  "                                                                                                                                ", 
  "                                                                                                                                ", 
  "                                                                                                                                ", 
  "                                                                                                                                ", 
  "                                                                                                                                ", 
  "                                                                                                                                ", 
  "                                                                                                                                ", 
  "                                                                                                                                ", 
  "                                                                                                                                ", 
  "                                                                                                                                ", 
  "                                                                                                                                ", 
  "                                                                                                                                ", 
  "                                                                                                                                ", 
  "                                                                                                                                ", 
  "                                                                                                                                ", 
  "                                                                                                                                ", 
  "                                                                                                                                ", 
  "                                                                                                                                ", 
  "                                                                                                                                ", 
  "                                                                                                                                ", 
  "                                                                                                                                ", 
  "                                                                                                                                ", 
  "                                                                                                                                ", 
  "                                                                                                                                "
 ]
}