{
 "keys": [
  "", 
  "71", 
  "24", 
  "245", 
  "207", 
  "238", 
  "82", 
  "132", 
  "205", 
  "51", 
  "65", 
  "186", 
  "165", 
  "114", 
  "2", 
  "120", 
  "235", 
  "116", 
  "13", 
  "113", 
  "41", 
  "234", 
  "34", 
  "78", 
  "48", 
  "15", 
  "90", 
  "173", 
  "215", 
  "1", 
  "75", 
  "224", 
  "181", 
  "79", 
  "42", 
  "158", 
  "208", 
  "38", 
  "127", 
  "167", 
  "212", 
  "76", 
  "39", 
  "164", 
  "183", 
  "87", 
  "69", 
  "104", 
  "77", 
  "157", 
  "59", 
  "21", 
  "49"
 ], 
 "data": {}, 
 "grid": [
  "                                                                                                                                ", 
  "                                                                                                                                ", 
  "                                                                                                                                ", 
  "                                                                                                                                ", 
  "                                                                                                                                ", 
  "                                                                                                                                ", 
  "                                                                                                                                ", 
  "                                                                                                                                ", 
  "                                                                                                                                ", 
  "                                                                                                                                ", 
  "                                                                                                                                ", 
  "                                                                                                      !!!!!                     ", 
  "                                                                                                    !!!!!!!!!!                  ", 
  "                                                                                                !!! ! !!!!!!  !                 ", 
  "                                                                         ### ####                !!!!!!!!!!!!!!                 ", 
  "                                                                      ### #########           !  !!!!!!!!!!!!!!!                ", 
  "                                                                       ############            !!!! !!!!!!!!!!!!!               ", 
  "                                                                      ##############        !  !!!!!!!!!!!!!!!!!!               ", 
  "                                                                   ## ###############    !  !! !!!!!!!!!!!!!!!!!                ", 
  "                                                                 # #################   !!! ! !! !!!!!!!!!!!                     ", 
  "                                                                ###################  !!!!!!!!!!! !!!!!!!!! !!! !!   !           ", 
  "                                                               ##################    !!!!!!!!!!!!!!!!!!!!!!!!! !!!  !!!         ", 
  "                                                                ################# #  !!!!!!!!!!!!!!!!!!!!!!!!!!!!! !!!!!        ", 
  "                                                             ##  #################   !!!!!!!!!!!!!!!!!!!!!!!!!!! !!!!!!         ", 
  "                                                             ## ######## ########  !!!!!!!!!!!!!!!!!!!!!!!!!!!!!!!!!!!          ", 
  "                                                            ###  ####### ######## !!!!!!!!!!!!!!!!!!!!!!!!!!!!!!!!!!!!          ", 
  "                                                            ####   ##  ######### !!!!!!!!!!!!!!!!!!!!!!!!!!!!!!!!!!             ", 
  "                                                            ######    ########  !!!!!!!!!!!!!!!!!!!!!!!!!!!!!!!!!!!!!           ", 
  "                                                             ##### ## ########  !!!!!!!!!!!!!!!!!!!!!!!!!!!!!!!!!!!             ", 
  "                                                         #  ##################    !!!!!!!!!!!!!!!!!!!!!!!!!!!!!!!!!!            ", 
  "                                                            ###### ### #####      !!!!!!!!!!!!!!!!!!!!!!!!!!!!!!!!!             ", 
  "                                                            ## ###########        !!!!!!!!!!!!!!!!!!!!!!!!!!!!!!!!              ", 
  "                                                     ##       ##### #######      !!!!!!!!!!!!!!!!!!!!!!!!!!!!!!!!!!!            ", 
  "                                                      ###     #### # ######    !!!!!!!!!!!!!!!!!!!!!!!!!!!!!!!!!!!!!            ", 
  "                                                 ##   ######  #############  !!!!!!!!!!!!!!!!!!!!!!!!!!!!!!!!!!!!!              ", 
  "                                                      #### ## ############# !!!!!!!!!!!!!!!!!!!!!!!!!!!!!!!!!!!!! !             ", 
  "                                                  #      # ##       #######  !!!!!!!!!!!!!!!!!!!!!!!!!!!!!!!!!!!!!              ", 
  "                                                ##      #   ##    # #####     !!!!!!!!!!!!!!!!!!!!!!!!!!!!!!!!!!!!!!            ", 
  "                                            ##  ##   #       # ## ## ####     !  !!!!!!!!!!!!!!!!!!!!!!!!!!!!!!!!!!             ", 
  "                                           ### #      #          #######       !!!!!!!!!!!!!!!!!!!!!!!!!!!!!!!!!!!!!            ", 
  "                                           ### #           ###   ########      !!!!!!!!!!!!!!!!!!!!!!!!!!!!!!!!!!!!!            ", 
  "                                          ### #   #   # ### ########## ##     !!!!!!!!!!!!!!!!!!!!!!!!!!!!!!!!!!!!              ", 
  "                                         ### #### ##  # ###   ##      #        !!!!  !!!!!!!!!!!!!!!!!!!!!!!!!!!!!              ", 
  "                                            # ### ###  ####    ##   ###               !!!!!!!!!!!!!!!!!!!!!!!!!!!!              ", 
  "                                             ########    ##### #########               !!!!!!!!!!!!!!!!!!!!!!!!!!!!             ", 
  "                                             ### #### #  ## ## #########               !!!!!!!!!!!!!!!!!!!!!!!!!!! !            ", 
  "                                               ###           # ########                !!!!!!!!!!!!!!!!!!!!!!!!!!!              ", 
  "                                        ###                                             !!!!!!!!!!!!!!!!!!!!!!!!!!!             ", 
  "                                        ######            #  ####                       !!!!!!!!!!!!!!!!!!!!!!!!!!              ", 
  "                                        ######     ###   ## #### ### ####               !!!!!!!!!!!!!!!!!!!!!!!!!!              ", 
  "                                        #######    ###   ## #### ## ######              !!!!!!!!!!!!!!!!!!!!!!!!                ", 
  "                                       ######## # #### ########  ###### ##              !!!!!!!!!!!!!!!!!!!!!!!!!               ", 
  "                                       ############ ##  #### #  ### #### ##              !!!!!!!!!!!!!!!!!!!!!! !               ", 
  "                                       #### ####### ##   ###    ############             !!!!!!!!!!!!!!!!!!!!!!!                ", 
  "   $                                    ### ##########    # ##  ##############           ! !!!!!!!!!!!!!!!!!!!!!!               ", 
  "                %%%                         ##########      ##   #############             !!!!!!!!!!!!!!!!!!! !!         &     ", 
  "              %%%%%%%                #       #  #######     ###  ###############          !!!!!!!!!!!!!!!!!!!! !!               ", 
  "             %%%%%%%%%%%% %        # # #     ############   ###   ###### #######         !!!!!!!!!!!!!!!!!!!!!!!!               ", 
  "            %%%%%%%%%%%%%%%%##    ###### ##  ##########   ######    ## ##########         !!!!!!!!!!!!!!!!!!!!!!                ", 
  "           %%%%%%%%%%%%%%%%%### #############  ##### ###  ## ###    ### # ######            !!!!!!!!!!!!!!!!!!!                 ", 
  "          %%%%%%%%%%%%%%%%%%###################### ###     #  #### #### #  #####           !!!!!!!!!!!!!!!!!!!                  ", 
  "          %%%%%%%%%%%%%%%%%%###################   # ###   ############   #########        !!!!!!!!!!!!!!!!!                     ", 
  "            %%%%%%%%%%%%%%%%###################################### ####  ##  ######       !!!!!!!!!!!!!!!                       ", 
  "             %%%%%%%%%%%%%%%###########################################     ########      !!!!!!!!!!!!!!                        ", 
  "           % %%%%%%%%%%%%%%%##########################################      #########     !!!!!!!!!!!!!!            '           ", 
  "         %%%%%%%%%%%%%%%%%%%####################################### #       ##### ##       !!!!!!!!!! !        '' ''''          ", 
  "          %%%%%%%%%%%%%%%%%%###################################### ##    ######## ##       !!!!!!!!!            '''''''         ", 
  "     $    %%%%%%%%%%%%%%%%%%###################################### ###   #########         ! !!!!!!!            ''''''          ", 
  "              %%%%%%%%%%%%%%###################################### ####     #######        !!!!!!!!!            '''''           ", 
  "      %%     %%%%%%%%%%%%%%%####################################   #  # #    ######         !!!!!!!                '            ", 
  "           %%%%%%%%%%%%%%%%%###################################      #        ### #         !!!!!!!                             ", 
  "          %%%%%%%%%%%%%%%%%%###################################        # ####   ##           !!!!!                         (    ", 
  "          %%%%%%%%%%%%%%%%%%##################################           #####               !!!!!                         (    ", 
  "           %%%%%%%%%%%%%%%%%#################################           #######               !!!!                              ", 
  "         %%%%%%%%%%%%%%% %%%%%###############################            ######   #             !!                             )", 
  "             %%%%%% %%       %#%%############################            ######   #                                             ", 
  "             % %%%%           %%%#############################          ######## ###                                         )  ", 
  "                %%%%           %%%#############################          ###########                                       )))  ", 
  "                % %%            %%##############################          ###########                                       ))) ", 
  "              %%% %             %%%###############################      # ###########                                      )))) ", 
  "             %%                  %%%################################     #############                                      ))) ", 
  "           %% %                   %%##################################  ###############                                   *) )))", 
  "          %                       ####################################  ################                                 ***  ))", 
  "        %                         # #####################################################                                *** )))", 
  "    % %                              ################################## #################                                *** )))", 
  "  %                                  ################################## #################                                *   )))", 
  "                                     ################################################# #                                     )))", 
  "                                      ########################################### #    ###                                     +", 
  "                                       ##%%%%%%%%%%%%%%%%%%%%%#####################   ####                                   + +", 
  "                                        %%%%%%%%%%%%%%%%%%%%%%%%%%%################   #####                                  +++", 
  "                                        %%%%%%%%%%%%%%%%%%%%%%%%%%%%###########%##   #  # #                                    +", 
  "                                        %%%%%%%%%%%%%%%%%%%%%%%%%%%%%#########%%######                                         +", 
  "                                        %%%%%%%%%%%%%%%%%%%%%%%%%%%%%%#####%%%%%% ##                                           +", 
  "                                        %%%%%%%%%%%%%%%%%%%%%%%%%%%%%%####%%%%%% #                                             +", 
  "                                        %%%%%%%%%%%%%%%%%%%%%%%%%%%%%%##%%%%%%                                            ,,,,,,", 
  "                                        %%%%%%%%%%%%%%%%%%%%%%%%%%%%%%%%%%%%%%%                                           ,,,,,,", 
  "                                        %%%%%%%%%%%%%%%%%%%%%%%%%%%%%%%%%%%%%                                             -,,,,,", 
  "                                        %%%%%%%%%%%%%%%%%%%%%%%%%%%%%%%%%%%%                                              -,,,,,", 
  "                                        %%%%%%%%%%%%%%%%%%%%%%%%%%%%%%%%%%%                                               -,,,,,", 
  "                                         %%%%%%%%%%%%%%%%%%%%%%%%%%%%%%%%%%                                               -,,,,,", 
  "                                          %%%%%%%%%%%%%%%%%%%%%%%%%%%%%%%%%                                                 ,   ", 
  "                                          %%%%%%%%%%%%%%%%%%%%%%%%%%%%%%%%%                                                 .../", 
  "                                           %%%%%%%%%%%%%%%%%%%%%%%%%%%%%%                                                  ..../", 
  "                                             %%%%%%%%%%%%%%%%%%%%%%%%%%%                                                  ......", 
  "                                             000%%%%%%%%%%%%%%%%%%%%%%%                                                  .....//", 
  "                                              0 000000%%%%%%%%%%%%%%%%%                                                  ....///", 
  "                                              00000000%0%%%%%  %%    %%                                                  ../////", 
  "                                              00 00000000%%%         %%                                             ,,, ..//////", 
  "                                               00 00000000%           %%                                               1112/////", 
  "                                                00000000000           %                                               112222////", 
  "                                                 0  0000000               3                                          111222244//", 
  "                                                  0  000000          555                                             1112222444/", 
  "              %                                     0000000         555555   6                                      111222224444", 
  "                                                     0000000    000     5555                                         22222224444", 
  "                 %                               0    000000   000    7     899                                      22222224444", 
  "                                                        000000000:       ;   9  < = >                                22222224444", 
  "                                                          000000?:                  @                                AA222222444", 
  "                                                              0??BBBB                                          C    AAAA24444444", 
  "                                                                ?BBDD                                               AAAA444444EE", 
  "                                                                  DDD        FG                                     AAHA44444EEE", 
  "                                                                   DD      FFIII  I                                   JJJJ44EEEE", 
  "                                                                   KKL    FFI IIIIIII                                  MMJNNNNEO", 
  "                                                                     LL LLFFFIIIIIIIII                                 MMPNNNNNO", 
  "                                                                         FFFFIIIIIIIIIQ                                 PPPNNNOO", 
  "                                                                         FFFFFFFIIIIIQQQRRS                              PPNNNNO", 
  "                                                                         FFFFFFFIIIITTQRRRSS                                    ", 
  "                                                                        FFFFFFFFIIITTTQQRRST                                    ", 
  "                                                                        UFFFFFFTTIITTTQTTTTTT                                   "
 ]
}