{
 "keys": [
  "", 
  "67", 
  "27", 
  "28", 
  "204", 
  "92", 
  "185", 
  "223", 
  "52", 
  "203", 
  "29", 
  "166", 
  "6", 
  "177", 
  "221", 
  "227", 
  "20", 
  "123", 
  "9", 
  "122", 
  "141", 
  "108", 
  "151", 
  "222", 
  "61", 
  "216", 
  "180", 
  "124", 
  "178", 
  "219", 
  "179", 
  "159", 
  "146"
 ], 
 "data": {}, 
 "grid": [
  "       !!!###$$$$$$$$%%%%&&&&''                                       ((((    (((((( (     (((                                  ", 
  "    )  !!!!#$$$$$$$$$%****&&&&                                          ((((  (((((  ((    ( ((((((                             ", 
  "       !!###$$$$$$$$$+*****&&                                          ((((((  ((((  (((  ((( (( ((((,      ,                   ", 
  "        ##$$$$$$$$$$$*******&                                            (((         ( (        (((((,,,    ,                   ", 
  "         $$$$$$$$$$$$*******                                              ((    (      ((          ((,,,,,,,  ,                 ", 
  "         ---$$-$$$$$$$*******           .                                   (((((     (            ((,,,,                       ", 
  "          ------$$$$$//*****                                                     ((((((((00       ( (,, ,,      1 1             ", 
  "          ------$$$$$///2****                                                        (  (            3   ,,       1             ", 
  "          -------//$////2***4                                                                33  3   3       ,                  ", 
  "         --------///////24444   5  6                                                         33333   33                         ", 
  "         -------////////22444     66                                                      3 333333   33                7        ", 
  "         -------//////4442444    666                                                     333333333   333                        ", 
  "         -------////888842444   6666                                                   33333333333333333                      99", 
  "         :::::::::888888444     6666                                                   33333333333333333                      99", 
  "         ::::::;;;;8888844      666                                                   3333333333333333333                7      ", 
  "          :::::;;;;;88884      6666                                               333333333333333333333333           <          ", 
  "          :::::;;;;;;88444     6666                                              333333333333333333333333333          <         ", 
  "           ::::;;;;;===444     666                                               333333333333333333333333333                    ", 
  "           ::::;;;;====44      666                                               3333333333333333333333333333                   ", 
  "           ::::;;=====>4                                                         3333333333333333333333333333                   ", 
  "           ::::=======>=                                                         33333333333333333333333333333                  ", 
  "            :::=========                                                          3333333333333333333333333333                  ", 
  "            =======??==                                                           3333333333333333333333333333                  ", 
  "             =========                                                            333333333333333333333333333                   ", 
  "             ========                                                             3333333333  333333333333333                   ", 
  "             =======                                                              3333333       333333333333                    ", 
  "              ==                                                                  333             3333333333               @    ", 
  "                                                                                                  3333333333                @   ", 
  "                                                                                                    3333333                 @@  ", 
  "                                                       A                                            333333                   @@ ", 
  "                                                                                                      3 3                   @@@ ", 
  "                                                                                                         3                   @  ", 
  "                                                                                                       333                 @@@  ", 
  "                                                                                                        33                @@    ", 
  "                                                                                                        33               @@     ", 
  "                                                                                                                        @@@     ", 
  "                                                                                                                       @@@      ", 
  "                                                                                                                       @@@      ", 
  "                                                                                                                       @        ", 
  "                                                                                                                                ", 
  "                                                 AA                                                                             ", 
  "                                                                                                                                ", 
  "                                                                                                                      @         ", 
  "                                                                                                                                ", 
  "                                                                                                                        @       ", 
  "                                                                                                                                ", 
  "                                                                                                                                ", 
  "                                                                                                                                ", 
  "                                                                                                                                ", 
  "                                                                                                                                ", 
  "                                                                                                                                ", 
  "                                                                                                                                ", 
  "                                                                                                                                ", 
  "                                                                                                                                ", 
  "                                                                                                                                ", 
  "                                                                                                                                ", 
  "                                                                                                                                ", 
  "                                                                                                                                ", 
  "                                                                                                                                ", 
  "                                                                                                                                ", 
  "                                                                                                                                ", 
  "                                                                                                                                ", 
  "                                                                                                                                ", 
  "                                                                                                                                ", 
  "                                                                                                                                ", 
  "                                                                                                                                ", 
  "                                                                                                                                ", 
  "                                                                                                                                ", 
  "                                                                                                                                ", 
  "                                                                                                                                ", 
  "                                                                                                                                ", 
  "                                                                                                                                ", 
  "                                                                                                                                ", 
  "                                                                                                                                ", 
  "                                                                                                                                ", 
  "                                                                                                                                ", 
  "                                                                                                                                ", 
  "                                                                                                                                ", 
  "                                                                                                                                ", 
  "                                                                                                                                ", 
  "                                                                                                                                ", 
  "                                                                                                                                ", 
  "                                                                                                                                ", 
  "                                                                                                                                ", 
  "                                                                                                                                ", 
  "                                                                                                                                ", 
  "                                                                                                                                ", 
  "                                                                                                                                ", 
  "                                                                                                                                ", 
  "                                                                                                                                ", 
  "                                                                                                                                ", 
  "                                                                                                                                ", 
  "                                                                                                                                ", 
  "                                                                                                                                ", 
  "                                                                                                                                ", 
  "                                                                                                                                ", 
  "                                                                                                                                ", 
  "                                                                                                                                ", 
  "                                                                                                                                ", 
  "                                                                                                                                ", 
  "                                                                                                                                ", 
  "                                                                                                                                ", 
  "                                                                                                                                ", 
  "                                                                                                                                ", 
  "                                                                                                                                ", 
  "                                                                                                                                ", 
  "                                                                                                                                ", 
  "                                                                                                                                ", 
  "                                                                                                                                ", 
  "                                                                                                                                ", 
  "                                                                                                                                ", 
  "                                                                                                                                ", 
  "                                                                                                                                ", 
  "                                                                                                                                ", 
  "                                                                                                                                ", 
  "                                                                                                                                ", 
  "                                                                                                                                ", 
  "                                                                                                                                ", 
  "                                                                                                                                ", 
  "                                                                                                                                ", 
  "                                                                                                                                ", 
  "                                                                                                                                ", 
  "                                                                                                                                ", 
  "                                                                                                                                ", 
  "                                                                                                                                ", 
  "                                                                                                                                ", 
  "                                                                                                                                ", 
  "                                                                                                                                "
 ]
}